11111111
1001E111
10000111
1P001111
11111111