1111111111111111111111111111111111
1E01000000000000C00000C00000000011
1110101001000001010010000000101001
1010010010101010001001000000010101
1P0000000C00C0000000000000000000C1
1111111111111111111111111111111111