1111111111111111111111111111111111
1E01P00000000000C00000C00000000011
1111111111111111111111111111111111