1111111111111111111111111111111111
1C11G00000000000100000000000000001
10000101001000111010010000G0010111
1110010010101010001001000000011101
1P0000000C0EC0000000000000G0000001
1111111111111111111111111111111111