1111111111111111111111111111111111
1E000C000000001C000000100000000001
1000010100100001001001000000010101
1000110010101000001001000000011111
1P00000C00C0000G0000000000000000C1
1111111111111111111111111111111111