1111111111111111111111111111111111
1C11G0000000000C10000C000000000001
1G000101001000111010010000G0010111
1110010010101010001001000000011101
1P0000000C0EC0000000000000G00000C1
1111111111111111111111111111111111
