1111111111111111111111111111111111
10000000000000C00000C0000000000001
10100101001000001010100G0000101001
1E100100101010100010010000P0010101
1111111111111111111111111111111111