1111111111111111111111111111111111
10E01000000000C0000C10000000000001
1111010100100000101001000000010101
1111110010101010001001000000011111
1P00000C00C000000000000000000000C1
1111111111111111111111111111111111