1111111111111111111111111111111111
100000000000000C0000EC100000000001
1110010100100000101001000000010101
1111110010101010001001000000011111
1P00000C00C000000000000000000000C1
1111111111111111111111111111111111